##########################################################
|| -    .   .  -         -    -     .  .    .     -     ||
|| . %%%%%%%%%%%%%%%%                %%%%%%%%%%%%%%  -  ||
|| .        |%|   |%|     |%|        |%|        |%|     ||
|| -        |%|   |%|     |%|        |%|        |%|  -  ||
|| .        |%|       . . |%|       ...............     ||
|| .        %%%%%%%%%%. . |%|       %%%%%%%%%%%%     .  ||
|| .                                |%|              .  ||
|| .|%|  |%|%%%|%|     |%|                   |%|        ||
|| .|%|  |%|   |%|..    %%%%%%%%%%%%%       .|%|        ||
|| .|%|  |%|   |%|..           .-.|%|     %%%%%%        ||
|| -|%|            .           .-.|%|                   ||
||   .......-...........-............-...........    -  ||
|| .|%|  |%|   |%|..          %%%%%%%  ......|%|        ||
|| .|%|  %%%%%%%%%             .-.|%|        |%|     .  ||
|| -|%|  %%%%%%%%%             .-.|%|        |%|        ||
||                                                   .  ||
|| .|%|  |%|%%%|%|     |%|                   |%|        ||
|| -|%|  |%|   |%|.-    %%%%%%%%%%%%%       .|%|     -  ||
||......-.........-............-...........-.........-..||
||                                                      ||
##########################################################